0   0   0   0   0   0   0   0   0   0   0   0   0   0   0   0   0   0   0   0   0   0   0   0   0   0   0   0
0   30  30  30  30  30  30  30  30  0   30  30  30  30  30  30  30  30  0   30  30  30  30  30  30  30  30  0
0   30  30  30  30  30  30  332 333 0   30  30  30  30  30  30  332 333 0   30  30  30  30  30  30  332 333 0
0   30  30  30  30  30  30  365 366 0   30  30  30  30  30  30  365 366 0   30  30  30  30  30  30  365 366 0
0   30  30  30  30  0   0   0   0   0   30  30  30  30  0   0   0   0   0   30  30  30  30  0   0   0   0   0
0   0   0   0   30  30  30  30  30  0   0   0   0   30  30  30  30  30  0   0   0   0   30  30  30  30  0   0
0   30  30  30  30  30  30  30  30  30  30  30  30  30  30  30  30  30  30  30  30  30  30  30  30  30  0   0
0   30  30  30  30  30  30  30  30  30  30  30  30  30  30  30  30  30  30  30  30  30  30  30  30  30  0   0
0   30  30  30  30  30  30  30  30  30  30  30  30  30  30  30  30  30  30  30  30  30  30  30  30  30  0   0
0   30  30  30  30  30  30  30  30  30  30  30  30  30  30  30  30  30  30  30  30  30  30  30  30  30  0   0
0   30  30  30  30  30  30  30  30  30  30  30  30  30  30  30  30  30  30  30  30  30  30  30  30  30  0   0
0   30  30  30  30  30  30  30  30  30  30  30  30  30  30  30  30  30  30  30  30  30  30  30  30  30  0   0
0   30  30  30  30  33  33  33  33  33  33  33  33  33  33  33  33  33  33  33  33  33  33  33  33  33  0   0
0   30  30  30  30  1   30  30  30  30  30  30  30  30  30  30  30  30  30  30  30  30  30  30  30  30  0   0
0   33  33  33  33  33  33  33  33  33  33  33  33  33  33  33  33  33  33  33  33  33  33  33  33  30  0   0
30  30  30  30  30  30  30  30  30  30  30  30  30  30  30  30  30  30  30  30  30  30  30  30  2   30  2   30
30  30  30  30  30  30  30  30  30  30  30  30  30  30  30  30  30  30  30  30  30  30  30  30  2   30  2   30
30  30  30  30  30  30  30  30  30  30  30  30  30  30  30  30  30  30  30  30  30  30  30  30  2   30  2   30
0   0   0   0   0   0   0   0   0   0   0   0   0   0   0   0   0   0   0   0   0   0   30  30  0   0   0   0
