30  30  30  30  30  30  30  0
30  30  30  30  30  30  30  0
30  30  30  30  30  30  30  0
30  30  30  30  0   0   0   0 0
0   0   0   30  30  30  30  0
30  30  30  30  30  30  30  0
30  30  30  30  30  30  30  0
30  30  30  30  30  30  30  0
30  30  30  30  30  30  30  0
0   30  30  30  30  30  30  0
0   30  30  30  30  30  30  0
0   30  30  30  30  30  30  0
0   1   1   0   0   30  30  0
0   30  30  30  0   30  30  0
0   30  30  30  0   30  30  30
0   396 397 30  0   30  30  30
0   429 430 30  0   30  30  30
0   0   0   0   0   30  30  30
