30  30  30  30  30  30  30  30  30  30  30  30  30  30  30  30  30  30  30  30  30
30  30  30  30  30  30  30  30  30  30  30  30  30  30  30  30  30  30  30  30  30
30  30  30  30  30  30  30  30  30  30  30  30  30  30  30  30  30  30  30  30  30
30  30  30  30  30  30  30  30  30  30  30  30  30  30  30  30  30  30  30  30  30
30  30  30  30  30  30  30  30  30  30  30  30  30  30  30  30  30  30  30  30  30
30  30  30  30  30  30  30  30  30  30  30  30  30  30  30  30  30  30  30  30  30
30  30  30  30  30  30  30  30  30  30  30  30  30  30  30  30  30  30  30  30  30
30  30  30  30  30  30  30  30  30  30  30  30  30  30  30  30  30  30  30  30  30
30  30  30  30  30  30  30  30  30  30  30  30  30  30  30  30  30  30  30  30  30
30  30  30  30  30  30  30  30  30  30  30  346 30  30  30  30  30  30  30  30  30
30  30  30  30  30  30  30  30  30  30  30  313 30  30  30  30  30  30  30  30  30
30  30  30  30  30  30  30  30  30  30  30  313 30  30  30  30  11  11  11  30  30
30  30  30  30  30  30  30  30  30  30  30  313 30  30  30  30  12  13  14  30  30
30  30  30  30  30  30  30  30  30  30  30  313 30  30  30  11  44  44  44  11  30
33  33  33  33  33  33  1   1   33  30  30  313 30  30  30  13  13  13  13  13  30
30  30  30  30  30  30  30  30  33  30  30  313 30  30  30  13  13  45  13  13  30
30  30  30  30  30  30  30  30  33  30  30  33  30  30  30  13  13  46  13  13  30
0   0   0   0   0   0   0   0   0   0   0   0   0   0   0   0   0   0   0   0   0
