30  30  30  30  30  30  30  30  30  30  30  30  30  30  30  30  30  30  30  30  0
30  30  30  30  30  30  24  30  30  30  30  30  30  30  30  30  30  30  30  30  0
30  30  30  30  30  30  30  30  30  30  30  30  30  30  30  30  30  30  30  30  0
0   0   0   0   0   0   0   0   0   30  30  30  30  30  30  30  30  30  30  30  0
0   0   0   0   0   0   0   0   0   30  30  30  30  30  30  30  30  30  30  30  0
0   0   0   0   0   0   0   0   0   30  30  30  30  0   0   0   30  30  30  30  0
0   0   0   0   0   0   0   0   0   30  30  30  30  0   0   0   30  30  30  30  0
0   0   0   0   0   0   0   0   0   30  30  30  30  0   0   0   30  30  30  30  0
0   0   0   0   0   0   0   0   0   30  30  30  30  0   0   0   30  30  30  30  0
0   0   0   0   0   0   0   0   0   30  330 331 30  0   0   0   30  330 331 30  0
0   0   0   0   0   0   0   0   0   30  363 364 30  0   0   0   30  363 364 30  0
0   0   0   0   0   0   0   0   0   0   0   0   0   0   0   0   0   0   0   0   0
