0  0  0  0  0  30  30  30  30  30  30  30  30  30  30  30  30  30  30  30  0
0  0  0  0  0  30  30  30  30  30  30  30  30  30  30  30  30  30  30  30  0
0  0  0  0  0  30  330 332 30  30  30  30  30  30  30  30  30  30  30  30  0
0  0  0  0  0  30  364 365 30  30  30  30  30  30  30  30  30  30  30  30  0
0  0  0  0  0  0   0   0   0   30  30  30  30  30  30  30  30  30  30  30  0
0  0  0  0  0  0   0   0   0   30  30  30  30  0   0   0   30  30  30  30  0
0  0  0  0  0  0   0   0   0   30  30  30  30  0   0   0   30  30  30  30  0
0  0  0  0  0  0   0   0   0   30  30  30  30  0   0   0   30  30  30  30  0
0  0  0  0  0  0   0   0   0   30  30  30  30  0   0   0   30  30  30  30  0
0  0  0  0  0  0   0   0   0   30  30  30  30  0   0   0   30  30  30  30  0
0  0  0  0  0  0   0   0   0   30  330 332 30  0   0   0   30  330 332 30  0
0  0  0  0  0  0   0   0   0   30  364 365 30  0   0   0   30  364 365 30  0
0  0  0  0  0  0   0   0   0   0   0   0   0   0   0   0   0   0   0   0   0
