32
17
30 30 30 30 30 30 30 30 30 30 30 30 30 30 30 30 30 30 30 30 30 30 30 30 30 30 30 30 30 30 30 30
30 30 30 30 30 30 30 30 30 30 30 30 30 30 30 30 30 30 30 30 30 30 30 30 30 30 30 30 30 30 30 30
30 30 30 30 30 30 30 30 30 30 30 30 30 30 30 30 30 30 30 30 30 30 30 30 30 30 30 30 30 30 30 30
30 30 30 30 30 30 30 30 30 30 30 30 30 30 30 30 30 30 30 30 30 30 30 30 30 30 30 30 30 30 30 30
30 30 30 30 30 30 30 30 30 30 30 30 30 30 30 30 30 30 30 30 30 30 30 30 30 30 30 30 30 30 30 30
30 30 30 30 30 30 30 30 30 30 30 30 30 30 30 30 30 30 30 30 30 30 30 30 30 30 30 30 30 30 30 30
30 30 30 30 30 30 30 30 30 30 30 30 30 30 30 30 30 30 30 30 30 30 30 30 30 30 30 30 30 30 30 30
0  0  0  0  0  0  0  0  0  0  0  0  0  0  0  0  0  30 30 30 30 30 30 30 30 30 30 30 30 30 30 30
0  0  0  0  0  0  0  0  0  0  0  0  0  0  0  0  0  30 30 30 30 30 30 30 30 30 30 30 30 30 0  0
0  0  0  0  0  0  0  0  0  0  0  0  0  0  0  0  0  30 30 30 30 30 30 30 30 30 30 30 30 30 0  0
0  0  0  0  0  0  0  0  0  0  0  0  0  0  0  0  0  30 30 30 30 30 30 30 30 30 30 30 30 30 0  0
0  0  0  0  0  0  0  0  0  0  0  0  0  0  0  0  0  30 30 30 30 0  0  0  0  0  30 30 30 30 0  0
0  0  0  0  0  0  0  0  0  0  0  0  0  0  0  0  0  30 30 30 30 0  0  0  0  0  30 30 30 30 0  0
0  0  0  0  0  0  0  0  0  0  0  0  0  0  0  0  0  30 30 30 30 0  0  0  0  0  30 30 30 30 0  0
0  0  0  0  0  0  0  0  0  0  0  0  0  0  0  0  0  30 30 30 30 0  0  0  0  0  30 30 30 30 0  0
0  0  0  0  0  0  0  0  0  0  0  0  0  0  0  0  0  30 30 30 30 0  0  0  0  0  30 30 30 30 0  0
0  0  0  0  0  0  0  0  0  0  0  0  0  0  0  0  0  0  0  0  0  0  0  0  0  0  0  0  0  0  0  0
